#####################
#E                  #
# ### ### ######### #
#   # #   #         #
### # ### # #########
#   #   # # #       #
# ### ### # ####### #
#         #       # #
######### ##### # # #
#       #   # # # # #
# ##### # ### # # # #
# #   # #     # #   #
# # # # ####### ### #
# # # #           # #
# # # ############# #
# # #     #   #   # #
# # ####### # ### ###
#           #      S#
#####################
